--------------------------------------------------------------------------------M----------------------------------------------------------------------------------o------------------------------------
--------------------------------------------------X-----------------------------------------------------------------------------------------------------------------------------------------------------
-------------------------------------------------------------------------------------------------------------------------------o------------------------------------------------------------------------
----------------------------------------------------------------------------------------------------------------------------------------------------------------------------?---------------------------
--------------------?--X--------------------------------------------------------------------------------------------------o-----------------------------------------------------------------------------
-------------------------------------------------------------------------B--------------------------------------------------------------------------------------------------?------------------------o--
------------------------B----------------------------------------------------------------------------------------------------B-----------------------------X--o-----------------------------------------
----------------------------------------------------------------------------------------------------------X--------------------------------------------------------------------------------------------v
---------------------------?---------------------------------------------------B-------------?-------------------------T----------------------------X------o-----------T-------------------------------f
-----------------------------------------------------------------------------------------------------------------------|---------------------------XX------------------|-------------------------------f
----------------------------------------------------------------------------------------B------------------------X-----|--------------------------XXX------------------|--------M---X--------o---------f
-----------------------X----------------------------------------XX----------------------------------------------XX-----|-------------------------XXXX------------------|--o----------------------------f
----------------------------?????X?----------BBBBBB---------------------X---------??---------------------------XXXX----|----------o-------------XXXXX------------------|----T--------------------------f
---------------------------------XX-------------------------------------XX------------------------------------XXXX-----|-----------------------XXXXXX------------------|----|---------------B----------f
m---X----------------------------XXX--------E----------E----------------XXX---E-----E----------------E-------XXXXX-----|------E----o--E-------XXXXXXX------X-----------|-E--|--------------------------X
XXXXXXXXXXXXXXXXXXXTXXXXXXXXXXXXXXXXXXXXXXXXXXXXXXX-XXXXXXXXXXXXXXXXXXXXXXXXXXXXXXXXTXXTXXXXXXXXXXXXXXXXXXXXXXXXXXXXX??|?XXXXXXXXXXXXXXXXXXXXXXXXXXXXX----XXXXXXXXXXXXX|XXXX|XXXXXXBXXXBB--XXXXXXXXXXXXX
